WWWWNWNNNWNNNNWWNWNNNWWWNNWWWNWWWWWWWWNWNNNNNWNNNWNWWNWWWNNWNNNNNNNNNWNNWWWNNNWWWWNNNNNNWNWNWNNNWNWN
WNNWWNNWWWNWWNNNNNWNWWWWWNWWWWNNNNWWNNWNWWWNWNWNNWWNWWNNNWNNNWWWNWWWNNNWNNNWNWNNNWNNNNNNNWWWWNWWNNNN
NNWWWWWWNWNNNWWWNWWWNNNWWWNNWWNWNNWNNNNWNNNWNNWWWWWWWWNNWNWNNNNWNNWWWNNWNWNNNWNWWNWWWWNNWWWWWWNNNNWN
NNWWNNNNNNWWNWWWNWNNNWNNWWWNNWWWWWWNNNNWNWWNNNWWNNNNNNNNWNWNWNWWNWWNWNNNWNWWNWNWNWWWNWNNNNWWNWWNWWWN
WWNNWWNWNWNNWWWWNWNNNNWNNNNNWWWWNWWNWWNNNNWWWNNWWNWNWWWWNWNNNWNWWWWNNNNNNWWWNNNWWNNNNNNNNWWWWWWNWNNN
WNWWWNNWNNNNWWWWNWNWWNNNNNNWWWWWWNNNNWWWNNWWNWWWWWWWWWWWNWWWWWNNNWWNNWWWNNNWNNWNWNNNWWNWNWNNNWWWNNWW
NWWWWNWWWWNNWNWWNWNWWWNNWNNNWWWWWWNWWNNWNNNNWWNNNWNWWWNWWWNWWWNWNWWNNNNNNNWWWWWWNNNNWNNNNNWWWWNWNNNW
WNWNWWWNNWWWWWWWWWWWWNWWNWWWWNWWWWWWWWNWWWNNNWWNNNWNNWWNWWNNWNNWNWWNNNWWNNWWWNNNWWNWNWWNWWNNWWNNWWWN
NNWWWNNWWWWWWNNNNWNWWNWWNWWNNWWNNWWWWWWWNWNNNWWNWNNWNNWNWNWWNNWWNWNWNWNNWWNNNWWNWNWNWNWWWNNWWNWWNNWW
WWWWWWNWWNNWNNWNWNWWNWNNWWWNWWNNNNWWWWNNWNNWWWWNWWWNNWNNNNNNWNWWWNWNNWNWNWNNWWNWNNWNWNWNNNWWNWNWNWNW
WWNWWNNWWWNNWWNNWNNNWNNWWNNNWNNWNWWWWWNWWWNNNNNNNNNNWNWNWWWNNNNWNWNNNNNNNNNNWWWNNNNWNNNNNNWNWWNWNWNW
WWWWWNNWNNWWNNNWNNNWNNWWNWNNNNNWWNWWWNWNNNWNNWNNNNNNWWWNWWNNNNNWNNWNNNWWWWNNNNWWWWNWWWWWWWWNNNWWNWWW
WWNNNNWNWWWNWWNNNNNWWWNWWNWWWNNWNNNNWNWNNWNNWWNNNNNWNNNNWNWNWNNWNWNNWWNWNWNNWWNWNWNNNWNNNNWNNNWNNNWN
WWNWNWNNWNNNNNWWWWNWNWNWWNWNNWWNNWNNWNWNWNNNWNNNNNNWNNWWNNWWWWNWNNWWNNNWNWNNNNNWWWWNNWWWNNNNWNWNNWNW
NWNNNNNWNNNNNNWWWNWNNNWWNNNWWNNNWNNNNNWWNWNNWWNNNNNWNWWWNWNNNWWNWNWWWWWNWWWWWNNWNWWNWNWWWWWNWWNWWNWN
WWWNNNWWWNWNNNNNNWWNWWNWWWWWNNWWNNWWNNNNNWNNNWNNNNWWNWWWWWNNNWNNWNNWNNWWNWNWWWNWWWNWWNWNWWWWNNNNNNNN
NNNWNWWWWWNWWNNNWNWNWWWWWWWNWNNWWNNNWWWNWNNNNWNNNWWWWWNWWNWWWWWWNNWWNWWWNNNNNNWWWWWWNWNNNWWNNWNNNNWN
WNWWNNNWWNWNWWNNWNWWWNWWNNNWWNNNNWNWWNWNWWNNNNNWWNNWNNWNNWWWNWWWNWNWWNWNNWWNNNWWWWWNNNNNWWWNNWWWNNWN
NNWWNWWWWNWWWNNNNWNWWWWNWNWWNNNWNWWNWWNWNNNNWWWNNWWWNWNNNWNNNNWNNWNWWNNWWWWNNWWNWWNNNWNNWNWNNWWNNWWW
WNNWNNNWNWNNWWNWNWNWNWWNWNNNNNWNNWNWWNWWWWWWNWWWNNWWWNWWNWNNWNWWWNWNNNNNWNNWWNNNNNWNNNNNNWWWWNWNWNNN
NNNWNWNNNWWWNWWNWNNWNNWWWNNNWNNWNNNWNWWWNWNWWWWNWNWNWNNNNNWWNWWWNWWWNWNNWWWNNWNWWWNNNNWNWWWNWNWNWNNN
WNWNNWWWWWNWNWWNNNNNWWWNWWNNWWWWWNWNWWWWNWWWWNNWWNWWNWWNWWNNWNNWWWNWWWNNNNNWNNWNNWNNNNWWNWNNWWWNWWWW
WWWNWNNWWWWNWWNNNNNWWWWNNNNWNWWWWWWWWWNNWWNWWWNWNNWNNNNWWWNWWNWNNNWNNNNWWNWNWNWNWWNWNNWWNWWNWNNNWNWW
NWWNNNWNWNNNNNNWWNNNWNNNWNNWWNNNNNWNNWWWNNWWWNNWWNNWNNNWNWWNNNNWNWNNWNWNWNNNNNNWNNNWWNWNNWWWNWWWNWNN
NWWWNWNWWWWNWWNNNWNNNWWNNNNNNNWNNNNWWWWWWNNWNWNNNNWNWNNWWWWWNWWWNNNWWNWNWNNNNNWWWWNWNNNNNWNWNWWNNWWN
NWNWWWNWNNNWNWNWWWNWNNNWNWNWNWWNWNNNNWNNWNNNWWNWWNWWWWWWWWWNWNNNNWNWNNNWWNNNNNWWNNNWNNNWWNNNNWWNWNNW
WNNNWNNNWNWNWWWNNWWWWNNNWNNNWWWWNWNNNNNWNWWWWWNWNWWNWNWNNWNWWWNNWWNWNWNNWNNNNNNNWNWNNWWWNWWWWWWWNNNN
NWWNNNWWNWWNNWWWWWNNNNNWWWNNWWWWNNWWNNNWNNWWNWWNWWNNNWWNNWWWNNNNNNNWNWWNWNNNNNWNNWWWWNNNNNNNNWWNNNWN
WWWWNNWWWNWNNNNNWNWNWNNNNNNNWNWNNWWNWWWWWNNNNWNNWWWWNWNWNWWWNNNNWNWWNWNNNWNWWWNNWNWNNWWWNWNWNWWNNNWN
NWNWNWWNWNNWWNWWWNWNWWNWWNNNNWNNWWNWNWWNWWWNWNNNNNNNNWNNWNWWWWNWNWWNWWWWWNWWNNWNWNWWNWNNWNWWWWNNNNNW
NNNNWNNNWWWNNNWNWNWWWWNWWWWWNNWNWNWWWNNWNNWWNNWNNNNNWNWWNWWNWNNWWNWNWNWWWNNWNNWNWNNNWNNNWWWWWNNWWWWN
NWNWWWNWWWNWWNNNWWWNWNNWWWWNNNWWNWNWNNWNNWWWWNWNWNNNNWWNNNNNNNNNNNNNNWWNNWWWWWWNWNNNNWNNNNWWWWNNWNWN
NWNWNWWWWWWWWNWNWWWNNWNNWNNNNWNWNNWWWNWWNNNWNNWWWWWNNWWNWNWWWWWWWNNNNWWNNNWNNWNNWWWNWNNWWNWWNNWWWNWN
NNWWNWWNNWWWWWNWNWWWWNWNNWWWWNWNNNWWWNWNNNWWNNNNWWNNNNWWNWNNNNNWNWWWNWWNNWWNWNNNNNNWNWWNNWNNNNWWNWWW
NWWNNNNWWNWWNNWWNNNWWWWNWWWNWNNNWNNWWWWNNNWWNWNNNWNNWNNWNWWWWWNNWNWWWNNWWNNNNNWWWNNWWNNWWWWWWWNWNWNN
NNWWWNWNWWWWNWWNNWNWWNWNWWNNWNNNWWWWWNNNNWWNNNNWWWWWNNWWWWWWWWWWWWNNWWWNWWNWWNNNWNWNNNWWWWNWWNWWNNNN
NNWWNWNNNNNWNNWNWNNNWWNNNWWWNNWNNNWNNWNNWNNWWNNNNWWWWWWWWWWWWWWWWWNWNNNWNNNWWWWNNWWNNNNWWNWWWWWWNWNW
NNNNWNNNWWWNWWNWNWNWNNNNNWWWWWWWNWNNWWNWNWNNWNNWNNWWWWNWWWWWWWWWWNNNNWNNWNWNWNWWWWNNWWWWNNNWNNNNNNNW
NWWNNWWNNWNWNWWNNNNWWNNNWNWWNNNNWWWNWWNWNNWWNNWNWWWNWNWNWWWWWWWWNNNNNWNWWNWNWWWWWWNWNNNWNWNNWWNNWNNN
NNWWNNNWNWNWWWNWWWWWNNNWWWWNNWWNWNNWNNWWNNNNWNNWWWNWWWNNWWWWWWWWWWWWWNNNNWWNNNNWWNNWNNWNNWNWNWWWWWNW
WWNNWWWWWWWWNWWWWWNWNNWNWWNNNNNNNWWNWNNWNNNWWWNNNNNWNWNWWWWWWWWWNNWNWWNWNNNWNWNWWWNWWWNWWWWWNNWNWNNW
WNNWNWWNNWNNWWWNNNWNWNWWWNNWWWWWNWWWNNNWWNWNWNNWNNNWNWWWWWWWWWWWWWWWWWNWWNWWWWWNWNWWWNWNWWWWWNWWNWWN
NNWNWWNWNWWNWWWNNWNNWWNWNNNWWNWNWNWNNNWNNWWNWWWNWNNNNWNWWWWWWWWWWWNWWWWNWWNNWWNNWNNWNNWNWWNNNWNNWWNW
NWNNNWWNNWNNWWNNNNWWWNWWWWWNWNWNNNNWWWNNWNWWWNWWWWNWNWNWWNWNWWWNWWWNNNWNWWNWWNNNWNWWWNWNWNWWWNWNNNWW
WWWNNWWNWWWWWNNNNNNNWWNNNWNNWWWNWWNNWNNWNWWNNNWNNNNNNNWNNNWNNNNNNWNNNNNWNWNNWNNWWNWNNWNWNWWWWWWNNWNW
WNWWNWNNWNWNNWWNNWNNWWNWWNNNWWWWNWWNNNNNWWWWNNNNWWWWNNNNNWNNWWNNWNNWNNNNNWNWNWWNNWWNNWWNNNWNNNWNWWNN
NWNWWNNNNWNNWWWNNNNWWWNNWWWNNNWWNNWWWNWNNNWNNNNWNWWNNNNNNNWNNWWWNWNNWWNNWNWWWWNWNWNWWNWWWWWNNNWWNNNW
NWNWWWNWWNWWNNWNWNNNNWNNWWNWNNWNNNNWWWNNWWNWNNNWNNWNWNNWNNNNWWWNWNWNNNNWWNNNNWNWWWNNNNNNWWWWNNNNNWWN
WNWWNNWWNWNWNWWWNNNWNNWWWWNWWWNWNNNWNNNNWNWNNNWNNWNWWNNNWWWWNNNNNWWWWNNWNWNWNNNNNNWWWNNWNWWNNWNWWWNW
WNNNNNNWNNWWWNNWWWNWNNWNNWNWWWNNWNWNNWWNWNWWNNWNWWNNWWWWWWWNNNWWWNNWNWNWNWWNWWNNNWWNNNNWNNWWWNWWNWNW
WNNNNNWWNNNNNNNNWNWWWWWWWWNNNNWWWNNNNWWWWWNWNWWNNNWWNNNNNNWWNWWNNWNNNNWNNNWWWNWNNWWWNNWNNWWWNWWWWNNN
NWNNWWNNWNNWWNNWWWWWWWWWWWWNNNWWNWNNWNWWNNWNWWWNNNWNNNNWWNNWWWWNNNWNWWWNNNWNWNWNNWNWNWNNWNNWWWWNNWNW
WNNNNNNNWNWNWNNWWNWWWWWWWWWNWWNWNNWNWWWWNNWNNWNNNWNWWWWWWWWNWWNWWNNNWWWWNWWWNWNNNWWNWNWWNWNNNNWNNNWN
NWWNNWWNNNNNNWWNWNWWWWWWWWWNWWNNWNWWWWNWWNWWNNWNWWWWWNWNNNNWWNWWNNWNNNWNWWNNNWNNWNNWNNWNNNNWWWWNWWWN
WNWWNNNNWNWWWNWNNWWWWWWWWWNNWWWWWWWNWWWNWWNWWWNWWNWNWNWWNWWWWNWNWWWWWWWNNNNNNNNWWNWWWNWNWWNWWWNNWNWW
WWWWNWWNWNNWNWWNWNWWWWWWWWNNWWWWWNWNWWWWWNNWWWWWNWWNWNNWNNNWWWWWWNWNWWWWNNWWWNWWNNWNWWWWWNNNNWWWNNWW
WWNWWNWNNNWWNNWWWNWWWWWWWWWNWWNNWNWWNWNNWNWWNWNWNWWWWWWNWNWWNWNWNWWWWWNNNNWWNWWWNNWNWNWNWNNNWNNNNNNW
WNNWWWWWNNWWNWWWNNWWWWWWWWWWWNNNNWWWWWWWNWWNWNWNNNWNWNNNWWWWNWWNNWWWNWWNWWNNWNNNWWNWNWNWWNWNNWNWWNWW
NNNNNWNNWNWNWWWNNWWNNNWNWWNNWWWWNNNWNNNWWWWWNNNWWWWNNNNNNNNNNNWNNNWWWNNWNNWNNNNWNNWNWNNNNNNWNNWNWWNN
WWNNNWWNNNNWWNWNWNNNWNNWWWNNNWNNWWNWWNNWNNNNWWWWNWNNWWNWNNWNWWNNWWNWNNNNWWWWNNWNWWWWNNNNNNNWNNNNNWWN
NWWNNNWWWWNWNNNNWWWNNWNWWWNNWWWNNNWWNNNWNNWNWNNWNWNWNNNNNNNWNWNNNWWWNNNNNWNWWNWNWWNNWNWNNNWNNWWNNWNN
WNWWNNNWWNNWWWNNWWNNWWNWWNNWNNNWNWNWNWNNWWNNWWNWWNNWNNWNNWWNWNNWWWNNWNNNWWNWNWNWWNNWNWNWWNNNNWWWWWWW
NWNNNNWWWWWWNNWWNWNWNWWWNWWNWWNNNNWNNNWWWWWWNWNWNWNNNWNNNNWWWWNNWNWWNNWWNWNWWNWNWNWWNNNWNNNNNNNWWNNN
NNWNNNNNNNWWWNNWWWWNWWWNNNWWWNWWNWNWNWNWWNWWNNWNWNWNNWWWNWWNWNNNWWWNWWNNWNWWWNNWWNNWWWWWWWNNWWNWWWNN
WNWNWNNWWNWWWWWNNWNWNWNNNNNWWWWWNWNWWNWNWWWWWNWNNNWWWNWWWWNNWNWWWWWNNNWNNNNWWNWWWWWWWWNNNNWWNNWNWWWW
NNWWWNWNNWWNNWNWNNWWNWWWWWWWWNWNWWWNWNWNNWNWNWNNWWWNWNNWNWWNNWNNWNNWNWWWWNWWWNNNNWNNWWWNWNWNNNWNWWNN
NNNWWNNWWWNNNWNNNWNNWNNNNWNNWWWNNWNWNNNWWNWWWWNNWWWWWNNNWWWNWNWNNWNWNNWWWWNNNNNNNNWWNWNWWNNNWNWWNNNN
WNNNNWNWNWNNWNWNNNWNNNWWNWWNNNWWNNWNWNNNWWNNNNWNWNNNWNWWWWWNWNWNNNNNNNNNNNWWNWWWWNWWWWWNWNWNNNNWNWWN
NWWWNWWNNNNWWWWNNWNWWNNNNWWNNNNNWWNNNNNNNNWWNWWNWNWWNWNWWNWWWNWNNNNWWWWNNNWWNNNNWWNWWWWWWNNWNWNNNWWN
WWNNWWNWNWNNNWNWNWNWWNWNWWWNWWWNWWWNNWWNNWWNNNNWWWNNWWNNWWNWWWWNNNWNNWWNNNNWNWNNNNWWNWWWNNNWNWWNWWNN
WWNWNNNWWWWNNNNWWNNWWNWWNNNNNWNWWWNWWWNNNWWWWNNWNWWNWNNNWWWWWNNNNNNNWNWNNWNWNNWWWNNWWWNWNNNWNWNWWWNN
WNNNWNWNWNWWNNNWWWNNNNWWNWNNNWNWWNWNNNNNNWWWWWWNNWNWWWNWNWNNWNNNNWNNWNWNWNNNNWNNNWWNNNNWWNNWWNWWWWNN
WWWNNWNNWNWWWWNNNNNNWNNNWNWNWNNNNNWWNNNWNWNNWWWNWNNNNWNNNWNNWNWWNWNWNWNWNNNNWWWNWWNNWNNWWWWNWWWWWNNW
NNNNNNNWNNWWWWWNNWWWWNNNWNWNWNWWWNWWNNNNNNWWWNWNNWNWNWWNWNNWWWWWWWNWNWWWNWNNNNWWNWWWNNNNWWNWNWWNWNWN
NWWWWNNWNWWWNWNNWWWNNNNNNNNNNWWNNNNWNNNNNNWWWWNWNWNWNWWNWWWWNNWNNNNNWWNWWNNNNWNWWWNNWWWWWWNWNWWNNNWW
WNNNNNNNWNNNNWWNNWWWNWWNWWWNWWWWNWWNNWNWNNWNWWWNNWWNNWNNNNWWNNWNNWNWNWWWNNNWNWWWNWNWNNNNWNWWNWNWWNNN
WNWNWWWNNNWWNNNWNNNWWNWNWNWWWWWWWNWWWNNWWNNNWNNWNWWWWWNWNWNWWWNWWNNNWNWWWNNNWNNNWNWNNWNNWWNWNWNWWNWW
WWNNNNWNNWNWNWNNNNNNNNWWNNNNWNNNWWWNNNWNNWWWNWNWNNWWNWWNWNWNWWNWWWNNWWWWWNWNWWWWNWNNNNNWNWNWWWWWNNWW
WWWNNNNNWWNNWWWWNWNWWNWWNWNWWNWNWWNWWWWNWWWWNNWNWWNNNWWWNNNNWNNWWWWNNWNNNNNNNNWWNWNWWWWWNNWWNWWNNNNN
NWWWWWWNWWNNNWWNWWNWWNNNWNNWWWWNWWNNNWWWWWNNWNNWWWNWWWNNNNWNNNWNNNWWWWNNNNWWNWNNNWNNWWNWWNWNWWWNNWWN
WNNWNNNNNWWNWNNWNNNWWNNNNWNNWNNWNNWWNNNNNWWNWWNNNNNNWWWWNWNNWNWWWWNNNNWWNNNWNWWWNNNWWNNNWNNWWWWNWWNW
WNWWNNNNWWWNWWWNWWWWWNWNNWWWNWNWNWNNNNWNNWWNNWWNNWWNWNWWWNWNWWNWWWNNNWWNWNNNNNNWWWNNNWWNNNWNWWNNNWNW
NWNWNNNWNNWWWWNNNNWNNWWNNWWNNNNWWWWWNWWNWNWNWNWNWNNNWNWNWNWNNNWWWWNNNWNNNWNNWWNNWWNNNNWWNNNWWNWNWNNW
NNNNWWWWNNWNWNWNNNWNNNWWNWNWWWWWNNWWNNWWWWWWWNNWWNNNWWWNWWWWWWWNNWNNNWNNWNNWNNWNNNWWWNWNWNNWWNNNWWNW
WWWNNWNNNNNWWWNWWNWNNWNNWNWNNNNWNNNWNWNWWWWWWWWNWWNNWNWWNNWNWNWNNNWWWWWWWNWNWNNWWNNNNNNNNWNNWNWNWWNW
NWWWNNWNNWNWWNNNWNWWNWWNNWNWNWNNNNWNWNNNWNNNNWWWWNWWWWNWWWWNNWWNNNWNWNWNNWNWWNNWNWWWNNWWWNWWNNWNWWWN
WNNNNNWNNWNNNWWNNNNNWWWNNWNNNNNNNNWNWNNNWWWWWWWWNWNWNNWNWNNWWWNWWNNWNNNWWNNNWNWNWWWNNWWNWNWNNNWNNNNW
WWWNNWWNNWWWNNWWWNWNWWNNNNNNNNWWWWWNNWNWWWWWNNNNNNNNNWWWNWNWWWNNWNNNWNNWWNNWNNNWNNNNNWWWWNWNNWWNNWNW
WWNNNNWNWWWWNNNWWNWWWWWWNNNNWWNNWWWNNWWWNNNNNNNNNNNNNWNWNWNWWNWWNWWNNNWNNWNWWWNWNWNNWWNWWWWWNWWWWNNW
WNNWNNNWWWWWWNWWWWNNWNWNWWNNNWWWWWNWNNWWNNNNNNNNNNNWNNNWNWNWNWWWNWWWWNNNNWWWNWNNWNNWWWNWNWWNNNNNNWNW
WWNNNWWNNWNWWNWWNWNNWWWNNNWNNNNWWWNNNNWWWWWWNNNNNNWWNWNWWNNWWNWWNNWWNNNWNNWNWWNNWNNNWWWNNNNNWNWWWWWW
NNNWWWWWWNWNWNWWNWNNNNNWNNWNNWNNNNNNNNWNWNWNNNNNNWWWNNWWNNWNNWNWNNWNNNWNNWWNNWWNNNNNNNWWWNNNWNWWNWWN
NWWNWWNNWNNNWNWWWWWNNNNNWNWNWWWNNWNNWNNWWWNNNNNNNWNWNNWNWNWNNWNWWWNWNWWNNWWNWWNWNWNNWNWNNWNNWNWNNNNN
NNNWWWWWWNWNNNNNWNNWNWNWNWNWNWWNNWWNNWNWWNNWNNNNWWNNNWWNWNNNWNWWNWWNWWNWWWWWNWWNNNNNNNNNWNWNWNNNNNNN
NWNWWWNNWNNNNWNNWNNWNNWNWWNWWNNWWWNNNWWNNWNNWNWNNNNNNWNNWWWNNWWWWNWNWWWWWWNNNWNNNNNWWWWNNNWWNNWWNNNW
WWNWWWNWNWNNWNNNWNNWWNNWNNWWWNWWNNWWWNNNNWWNWNWWWWWWWNNNNWWNWNNWWWWNNNWWWWWWWNWWWNWNNWWWNWWNWNWNNWWN
WNWNNNNWNNNWNNWWNNNNNWWWNNWWNNNWNNNWNWWWWNWWNNNNWNWWNNWNWNNNWWWNNWNNNWWWWNWWWWWNWWWWNWWNWWNWNWNWWNWN
WNNNNWNNWNWWWWNNWWNWWNNNWWWWNWNWWWWNNWWWNNNWNWNNNNNWWNNNWWNWNNWWWNNNWNWNWWNNWWWWWWNNNWWNWWWNWWWNNWWW
WWWNWWWNNWWWNNWNNNWNWWWNWWNWNWNNWNWNWWWWWNNWNWNNWNWNWNNWWNNNNNWNWWNNWNNWWNWNWWNWNWWNNWNNWWWNNWNNNNNW
WWNNWWWWWNNNWNWNWNNNWWWNNWWWWNWNNWWNNNNNWWNWWNNNNWWNWNWWWNWNWWNWNNWNNWWWWNNWWNWNWNNNNNWNWWWWWWWNWWWN
