NNNWNWNNWNWNWWNNNNNNNNWWWWNNWNWWWWWWWNWNNNNWNWNWWN
NNNNNWNWWNWNNWNWWNNNWNWWNWNWWNWWWNNWNWNWNWWWNNWWNW
NNNNNWWWNWWNWNWNWWWWNWWWNNNNNNWNWNNWNWWNWNWWWWWWNW
WNNWWWWNWWWWWNNWWNWNNNNWWNWNWWWNNNWNWWWWNWWWWWWWWW
NWWNNWNNNWWNNNWWWNWWNNNWNWNWWNNWWNWWWNNWNWNWWWWNNN
WWWNNWNNWWNWWNNNWNNWWNWNWNNWWWWWWWNWNNWWWNWWWWWWWN
NWNWWNNNWNNWNNWNNWWWWNWNWWNWNWNNNWWNNNNWWNWNWWNWNW
NNNWWNNNNNNNWNNNWWWWNNWNWNNNWWNNWNNNWNNWNWNWNNWWWN
WWWWWNNWWWNWNNNNWNWWNWWNNWWNNNWWWNNWNNNWWWWWWWWWWW
WNWNNWWWNNNWNNWWWNNWWWWWWWWWWWNWNWWNWNWNWWNWNWWNWN
NWNNNNWWWNNWNNWWNNWNWWWNNWWNNWWNWWWNWNNNNWWWNNWNNN
WNWNNNWNWWNWNNNNWNWNWNWWNWWNNNWWWNWWNWNNNNWNWNWWWN
NNWNWWNNWWWWNWWNWWWNWNNWNWWWNWNWNNNNNNWWWNNNNWWNNW
WWWNWWWWWWWNNWNNNNWWNNNNNNNNNNNNNNWNNNNNWNWNNWNWWW
NNWWNNWNWNNNWWNNNNNWNNNNWWNNWNWWNNNWNWWNWWNNNNWNNN
NWNNNWNNNNNNNNWWWNWNWWNWWNWNWWNNNWNNWWWWNWWWNNNNNW
WNWNNWNWWNNWWNNNNWWWNNNWWNWWNNNNWWWWNWNNNNNWWNWNNN
WWWNWWNWNWWWWNNWNNWNNWWNNNWWWNWNNWWNNNWNWWWWWNNNWN
NNNNNNWWNNNWNNNNWNNWWNNNWNWNNWNWNWWWWWNWNWWNWNNNNW
NNNWWWWNWWWWNNWWWNNWNNWNWWNWWNNWNNWWNNWNWNWNNWNNNN
NWNWWWNNNWWWNNWNNNWWWWNNNNNNWWWNNWNNNNNWNNWWNWNWNN
WWNNWWNNNNWNNWWWNNNWNNWWNNNWNWNWWWWWWWWWNWWWWWWWNW
NNNNNWNWWWNNWNNWWWWNWNNWWNWNWWNNWWNWNNWWWNNNWNWNNN
WWNWWNWWWNNWNNWWWNWWNNNNNNWWWNNWWNWWWWWNWWNNWNWNWW
NWWWNWWNNNWNWWNWNNNNNWWNNNWNNWWWWWWWNWNNWWWNWNNWNW
WNNNWNWWWWNNWWNWNWNWWNWWWWWNNNNNWWWWWNNWWWWWWWWNWN
WWWNWWNWNWWWNWWWNWWWNNWNNWWNWWNWWNWNNNNWNWWNNWNWNN
WNNNNWWNNWWWNNWWNNWNWNNWNNNNWWNNNWNWNWNNNWNWWWNNWN
WNNWWWWNNWNNNWWWNNWWWWNWWNWWWNWWNWNNWWNNNWWWWWWWWW
NWWNNWWWNNNNWWWNWWWWWWNWWWNWNWWWWNNNNNNNWWWWNNWWWN
NNNNNNNWNNNWWWWWNWNWWWWWNNWNWNWWNNWWNNNWWNWNNWNWWN
WNWWWWWNNWNNNWWNNWNNNWNWNWWNNWWWNNWWWWNNNWWWNNNNWN
WWWWNNNWNWWWWWWNNWNWNNNNNNNNWWNNNWWNWWNNWWWWNWNWNW
NWNWWNWWNNNWNWWNNNNWWWNWWNNNWNWWNWNWNNWWNNWNNWNNNW
NNNNNNNNWWWWNNNNNNNNWNNWWWNNWNWWWWNWWWNNNNNWWWNWNN
NWWNWNWNWWWWWWNNWWWWNWWNNNWNWWWWWNWNWWNNWWNNNNNNNN
NWWNNWWWNWNNWNNNNNNWWWWNWWWWNWWNWWWNWNWNNNNWWWNWNN
WNWWWWWNNNWWWWNNNNWNWWWNWNWWWNWNWNNNNNNNWNWWWWWWNN
WNWNNWNNNNNNNWNNNWNNNWWNNNNWWNNNNWNNWNWWWWWWNWWNWN
NWNNWNNNWNNNWNWWNNNWNNWNWWWNWNWNNWNWNWWNNWWNWWNWWW
WNNNWWNNNWWWNNNNNNWWWWWWNWWWNNWNNWWWWNWNNNWWNNNNWW
NWWWNWWNNWNNWNNNWWWWNNWWNWNNNNWNWWWWNNNNNWNWWWNWNW
WNNNWWWNNNNWNWNNWWWWWWWNNNNNNNNNNNWNNNNNWWNWWNWNWN
WWNNNNWNWWWNNWWNNWWWWWNNNNWNWNNWNNNWNWNNNWNNNWNWNN
NNWWNNWNWNNNWWNNWWWNNWNNNNNNNWNWNNNWWWNWNNWNWWWWNN
NNNWNWWWNNNNWWNNWWWWNNNNNNWWNWNNNNWWWWWNNWWWWNWWWN
NNWWNNWNNNWNNNWNWNNWWWNNNNWWWNNWWWNNWNNNWWNWNWNWNN
NWNNWWNNWNNWWWNNNWWNWNWNNNWNNNNNWWNNWNNWWNWWWNNNWW
NNNWNNWNWWWWWNWNWNNNNNWWWNWNNWWWWWNWNNNNWNNNNNWWNW
WWNNWNNNNWWNNNWNWWWNNNNWWWWNNNWNWWWWNWWWNWWNWWNNNW
