WNWNWWNW
NWNWNWWW
NWWNNWWN
WWWNWNNW
WNNNWNNW
WNNNNWNW
NNNNNWWW
WWWNWWWN
